1111111111111111111111
1000000000000000100001
111011100000E000110001
1111111100000000000001
11111111000000000000C1
100000P000111111000011
1110010101111100111111
1111111111111111111111